########################
#...##....M..#.........#
E#....#S..###E#........#
##.#.....#...#.........#
#P....#...M.....E......#
E#######################
