##########
#.....#E##
#.M...#S.#
#........#
EP.......#
##########