##########
#.......E#
#........#
#........#
#P.......#
########MS